"filename", "language", "C++", "C", "comment", "blank", "total"
"/Users/summerpray/Documents/GitHub/RM_Infantry/CMSIS/core_cm4.h", "C++", 1033, 0, 416, 410, 1859
"/Users/summerpray/Documents/GitHub/RM_Infantry/CMSIS/core_cmFunc.h", "C++", 241, 0, 303, 121, 665
"/Users/summerpray/Documents/GitHub/RM_Infantry/CMSIS/core_cmInstr.h", "C++", 288, 0, 473, 156, 917
"/Users/summerpray/Documents/GitHub/RM_Infantry/CMSIS/core_cmSimd.h", "C++", 495, 0, 50, 153, 698
"/Users/summerpray/Documents/GitHub/RM_Infantry/CMSIS/stm32f4xx.h", "C++", 9449, 0, 1255, 1363, 12067
"/Users/summerpray/Documents/GitHub/RM_Infantry/CMSIS/stm32f4xx_conf.h", "C++", 102, 0, 48, 23, 173
"/Users/summerpray/Documents/GitHub/RM_Infantry/CMSIS/stm32f4xx_it.c", "C", 0, 32, 124, 16, 172
"/Users/summerpray/Documents/GitHub/RM_Infantry/CMSIS/stm32f4xx_it.h", "C++", 19, 0, 33, 9, 61
"/Users/summerpray/Documents/GitHub/RM_Infantry/CMSIS/system_stm32f4xx.c", "C", 0, 461, 440, 140, 1041
"/Users/summerpray/Documents/GitHub/RM_Infantry/CMSIS/system_stm32f4xx.h", "C++", 12, 0, 72, 22, 106
"/Users/summerpray/Documents/GitHub/RM_Infantry/FWLIB/inc/misc.h", "C++", 49, 0, 95, 35, 179
"/Users/summerpray/Documents/GitHub/RM_Infantry/FWLIB/inc/stm32f4xx_adc.h", "C++", 344, 0, 230, 83, 657
"/Users/summerpray/Documents/GitHub/RM_Infantry/FWLIB/inc/stm32f4xx_can.h", "C++", 264, 0, 281, 113, 658
"/Users/summerpray/Documents/GitHub/RM_Infantry/FWLIB/inc/stm32f4xx_cec.h", "C++", 133, 0, 126, 43, 302
"/Users/summerpray/Documents/GitHub/RM_Infantry/FWLIB/inc/stm32f4xx_crc.h", "C++", 16, 0, 52, 16, 84
"/Users/summerpray/Documents/GitHub/RM_Infantry/FWLIB/inc/stm32f4xx_cryp.h", "C++", 186, 0, 145, 54, 385
"/Users/summerpray/Documents/GitHub/RM_Infantry/FWLIB/inc/stm32f4xx_dac.h", "C++", 129, 0, 126, 50, 305
"/Users/summerpray/Documents/GitHub/RM_Infantry/FWLIB/inc/stm32f4xx_dbgmcu.h", "C++", 43, 0, 51, 16, 110
"/Users/summerpray/Documents/GitHub/RM_Infantry/FWLIB/inc/stm32f4xx_dcmi.h", "C++", 121, 0, 143, 49, 313
"/Users/summerpray/Documents/GitHub/RM_Infantry/FWLIB/inc/stm32f4xx_dfsdm.h", "C++", 465, 0, 257, 108, 830
"/Users/summerpray/Documents/GitHub/RM_Infantry/FWLIB/inc/stm32f4xx_dma.h", "C++", 304, 0, 206, 100, 610
"/Users/summerpray/Documents/GitHub/RM_Infantry/FWLIB/inc/stm32f4xx_dma2d.h", "C++", 167, 0, 186, 123, 476
"/Users/summerpray/Documents/GitHub/RM_Infantry/FWLIB/inc/stm32f4xx_dsi.h", "C++", 425, 0, 435, 152, 1012
"/Users/summerpray/Documents/GitHub/RM_Infantry/FWLIB/inc/stm32f4xx_exti.h", "C++", 77, 0, 74, 35, 186
"/Users/summerpray/Documents/GitHub/RM_Infantry/FWLIB/inc/stm32f4xx_flash.h", "C++", 272, 0, 175, 51, 498
"/Users/summerpray/Documents/GitHub/RM_Infantry/FWLIB/inc/stm32f4xx_flash_ramfunc.h", "C++", 19, 0, 67, 18, 104
"/Users/summerpray/Documents/GitHub/RM_Infantry/FWLIB/inc/stm32f4xx_fmc.h", "C++", 361, 0, 554, 229, 1144
"/Users/summerpray/Documents/GitHub/RM_Infantry/FWLIB/inc/stm32f4xx_fmpi2c.h", "C++", 199, 0, 178, 98, 475
"/Users/summerpray/Documents/GitHub/RM_Infantry/FWLIB/inc/stm32f4xx_gpio.h", "C++", 369, 0, 155, 69, 593
"/Users/summerpray/Documents/GitHub/RM_Infantry/FWLIB/inc/stm32f4xx_hash.h", "C++", 95, 0, 119, 44, 258
"/Users/summerpray/Documents/GitHub/RM_Infantry/FWLIB/inc/stm32f4xx_i2c.h", "C++", 208, 0, 411, 91, 710
"/Users/summerpray/Documents/GitHub/RM_Infantry/FWLIB/inc/stm32f4xx_iwdg.h", "C++", 38, 0, 73, 21, 132
"/Users/summerpray/Documents/GitHub/RM_Infantry/FWLIB/inc/stm32f4xx_lptim.h", "C++", 182, 0, 165, 40, 387
"/Users/summerpray/Documents/GitHub/RM_Infantry/FWLIB/inc/stm32f4xx_ltdc.h", "C++", 191, 0, 212, 101, 504
"/Users/summerpray/Documents/GitHub/RM_Infantry/FWLIB/inc/stm32f4xx_pwr.h", "C++", 99, 0, 104, 43, 246
"/Users/summerpray/Documents/GitHub/RM_Infantry/FWLIB/inc/stm32f4xx_qspi.h", "C++", 193, 0, 235, 66, 494
"/Users/summerpray/Documents/GitHub/RM_Infantry/FWLIB/inc/stm32f4xx_rcc.h", "C++", 642, 0, 308, 117, 1067
"/Users/summerpray/Documents/GitHub/RM_Infantry/FWLIB/inc/stm32f4xx_rng.h", "C++", 32, 0, 68, 22, 122
"/Users/summerpray/Documents/GitHub/RM_Infantry/FWLIB/inc/stm32f4xx_rtc.h", "C++", 392, 0, 372, 125, 889
"/Users/summerpray/Documents/GitHub/RM_Infantry/FWLIB/inc/stm32f4xx_sai.h", "C++", 260, 0, 277, 113, 650
"/Users/summerpray/Documents/GitHub/RM_Infantry/FWLIB/inc/stm32f4xx_sdio.h", "C++", 256, 0, 195, 86, 537
"/Users/summerpray/Documents/GitHub/RM_Infantry/FWLIB/inc/stm32f4xx_spdifrx.h", "C++", 108, 0, 120, 35, 263
"/Users/summerpray/Documents/GitHub/RM_Infantry/FWLIB/inc/stm32f4xx_spi.h", "C++", 238, 0, 214, 98, 550
"/Users/summerpray/Documents/GitHub/RM_Infantry/FWLIB/inc/stm32f4xx_syscfg.h", "C++", 173, 0, 136, 42, 351
"/Users/summerpray/Documents/GitHub/RM_Infantry/FWLIB/inc/stm32f4xx_tim.h", "C++", 593, 0, 398, 160, 1151
"/Users/summerpray/Documents/GitHub/RM_Infantry/FWLIB/inc/stm32f4xx_usart.h", "C++", 173, 0, 183, 78, 434
"/Users/summerpray/Documents/GitHub/RM_Infantry/FWLIB/inc/stm32f4xx_wwdg.h", "C++", 28, 0, 62, 22, 112
"/Users/summerpray/Documents/GitHub/RM_Infantry/FWLIB/src/misc.c", "C", 0, 62, 163, 25, 250
"/Users/summerpray/Documents/GitHub/RM_Infantry/FWLIB/src/stm32f4xx_adc.c", "C", 0, 518, 1064, 164, 1746
"/Users/summerpray/Documents/GitHub/RM_Infantry/FWLIB/src/stm32f4xx_can.c", "C", 0, 829, 876, 152, 1857
"/Users/summerpray/Documents/GitHub/RM_Infantry/FWLIB/src/stm32f4xx_cec.c", "C", 0, 144, 416, 49, 609
"/Users/summerpray/Documents/GitHub/RM_Infantry/FWLIB/src/stm32f4xx_crc.c", "C", 0, 31, 85, 18, 134
"/Users/summerpray/Documents/GitHub/RM_Infantry/FWLIB/src/stm32f4xx_cryp.c", "C", 0, 280, 579, 76, 935
"/Users/summerpray/Documents/GitHub/RM_Infantry/FWLIB/src/stm32f4xx_cryp_aes.c", "C", 0, 1104, 408, 196, 1708
"/Users/summerpray/Documents/GitHub/RM_Infantry/FWLIB/src/stm32f4xx_cryp_des.c", "C", 0, 136, 137, 40, 313
"/Users/summerpray/Documents/GitHub/RM_Infantry/FWLIB/src/stm32f4xx_cryp_tdes.c", "C", 0, 152, 138, 39, 329
"/Users/summerpray/Documents/GitHub/RM_Infantry/FWLIB/src/stm32f4xx_dac.c", "C", 0, 203, 448, 64, 715
"/Users/summerpray/Documents/GitHub/RM_Infantry/FWLIB/src/stm32f4xx_dbgmcu.c", "C", 0, 49, 114, 18, 181
"/Users/summerpray/Documents/GitHub/RM_Infantry/FWLIB/src/stm32f4xx_dcmi.c", "C", 0, 178, 311, 50, 539
"/Users/summerpray/Documents/GitHub/RM_Infantry/FWLIB/src/stm32f4xx_dfsdm.c", "C", 0, 823, 1140, 247, 2210
"/Users/summerpray/Documents/GitHub/RM_Infantry/FWLIB/src/stm32f4xx_dma.c", "C", 0, 424, 767, 111, 1302
"/Users/summerpray/Documents/GitHub/RM_Infantry/FWLIB/src/stm32f4xx_dma2d.c", "C", 0, 303, 369, 113, 785
"/Users/summerpray/Documents/GitHub/RM_Infantry/FWLIB/src/stm32f4xx_dsi.c", "C", 0, 815, 748, 208, 1771
"/Users/summerpray/Documents/GitHub/RM_Infantry/FWLIB/src/stm32f4xx_exti.c", "C", 0, 94, 180, 39, 313
"/Users/summerpray/Documents/GitHub/RM_Infantry/FWLIB/src/stm32f4xx_flash.c", "C", 0, 531, 938, 151, 1620
"/Users/summerpray/Documents/GitHub/RM_Infantry/FWLIB/src/stm32f4xx_flash_ramfunc.c", "C", 0, 23, 122, 14, 159
"/Users/summerpray/Documents/GitHub/RM_Infantry/FWLIB/src/stm32f4xx_fmc.c", "C", 0, 748, 608, 151, 1507
"/Users/summerpray/Documents/GitHub/RM_Infantry/FWLIB/src/stm32f4xx_fmpi2c.c", "C", 0, 511, 887, 157, 1555
"/Users/summerpray/Documents/GitHub/RM_Infantry/FWLIB/src/stm32f4xx_gpio.c", "C", 0, 201, 356, 55, 612
"/Users/summerpray/Documents/GitHub/RM_Infantry/FWLIB/src/stm32f4xx_hash.c", "C", 0, 173, 497, 57, 727
"/Users/summerpray/Documents/GitHub/RM_Infantry/FWLIB/src/stm32f4xx_hash_md5.c", "C", 0, 147, 133, 41, 321
"/Users/summerpray/Documents/GitHub/RM_Infantry/FWLIB/src/stm32f4xx_hash_sha1.c", "C", 0, 151, 133, 40, 324
"/Users/summerpray/Documents/GitHub/RM_Infantry/FWLIB/src/stm32f4xx_i2c.c", "C", 0, 493, 867, 103, 1463
"/Users/summerpray/Documents/GitHub/RM_Infantry/FWLIB/src/stm32f4xx_iwdg.c", "C", 0, 40, 203, 24, 267
"/Users/summerpray/Documents/GitHub/RM_Infantry/FWLIB/src/stm32f4xx_lptim.c", "C", 0, 262, 584, 106, 952
"/Users/summerpray/Documents/GitHub/RM_Infantry/FWLIB/src/stm32f4xx_ltdc.c", "C", 0, 480, 470, 161, 1111
"/Users/summerpray/Documents/GitHub/RM_Infantry/FWLIB/src/stm32f4xx_pwr.c", "C", 0, 274, 679, 101, 1054
"/Users/summerpray/Documents/GitHub/RM_Infantry/FWLIB/src/stm32f4xx_qspi.c", "C", 0, 343, 484, 85, 912
"/Users/summerpray/Documents/GitHub/RM_Infantry/FWLIB/src/stm32f4xx_rcc.c", "C", 0, 976, 1939, 278, 3193
"/Users/summerpray/Documents/GitHub/RM_Infantry/FWLIB/src/stm32f4xx_rng.c", "C", 0, 81, 294, 32, 407
"/Users/summerpray/Documents/GitHub/RM_Infantry/FWLIB/src/stm32f4xx_rtc.c", "C", 0, 1054, 1417, 295, 2766
"/Users/summerpray/Documents/GitHub/RM_Infantry/FWLIB/src/stm32f4xx_sai.c", "C", 0, 340, 745, 83, 1168
"/Users/summerpray/Documents/GitHub/RM_Infantry/FWLIB/src/stm32f4xx_sdio.c", "C", 0, 244, 663, 105, 1012
"/Users/summerpray/Documents/GitHub/RM_Infantry/FWLIB/src/stm32f4xx_spdifrx.c", "C", 0, 167, 283, 45, 495
"/Users/summerpray/Documents/GitHub/RM_Infantry/FWLIB/src/stm32f4xx_spi.c", "C", 0, 417, 803, 108, 1328
"/Users/summerpray/Documents/GitHub/RM_Infantry/FWLIB/src/stm32f4xx_syscfg.c", "C", 0, 204, 251, 67, 522
"/Users/summerpray/Documents/GitHub/RM_Infantry/FWLIB/src/stm32f4xx_tim.c", "C", 0, 1171, 1793, 402, 3366
"/Users/summerpray/Documents/GitHub/RM_Infantry/FWLIB/src/stm32f4xx_usart.c", "C", 0, 448, 922, 117, 1487
"/Users/summerpray/Documents/GitHub/RM_Infantry/FWLIB/src/stm32f4xx_wwdg.c", "C", 0, 61, 217, 30, 308
"/Users/summerpray/Documents/GitHub/RM_Infantry/user/AHRS/AHRS.h", "C++", 11, 0, 50, 9, 70
"/Users/summerpray/Documents/GitHub/RM_Infantry/user/AHRS/AHRS_middleware.c", "C", 0, 52, 71, 19, 142
"/Users/summerpray/Documents/GitHub/RM_Infantry/user/AHRS/AHRS_middleware.h", "C++", 35, 0, 22, 8, 65
"/Users/summerpray/Documents/GitHub/RM_Infantry/user/AHRS/ist8310driver.c", "C", 0, 73, 20, 17, 110
"/Users/summerpray/Documents/GitHub/RM_Infantry/user/AHRS/ist8310driver.h", "C++", 15, 0, 19, 7, 41
"/Users/summerpray/Documents/GitHub/RM_Infantry/user/AHRS/ist8310driver_middleware.c", "C", 0, 81, 19, 11, 111
"/Users/summerpray/Documents/GitHub/RM_Infantry/user/AHRS/ist8310driver_middleware.h", "C++", 17, 0, 17, 6, 40
"/Users/summerpray/Documents/GitHub/RM_Infantry/user/AHRS/mpu6500driver.c", "C", 0, 225, 28, 58, 311
"/Users/summerpray/Documents/GitHub/RM_Infantry/user/AHRS/mpu6500driver.h", "C++", 37, 0, 15, 12, 64
"/Users/summerpray/Documents/GitHub/RM_Infantry/user/AHRS/mpu6500driver_middleware.c", "C", 0, 118, 18, 32, 168
"/Users/summerpray/Documents/GitHub/RM_Infantry/user/AHRS/mpu6500driver_middleware.h", "C++", 21, 0, 7, 12, 40
"/Users/summerpray/Documents/GitHub/RM_Infantry/user/AHRS/mpu6500reg.h", "C++", 342, 0, 3, 147, 492
"/Users/summerpray/Documents/GitHub/RM_Infantry/user/APP/CAN_receive/CAN_receive.c", "C", 0, 192, 35, 58, 285
"/Users/summerpray/Documents/GitHub/RM_Infantry/user/APP/CAN_receive/CAN_receive.h", "C++", 41, 0, 25, 12, 78
"/Users/summerpray/Documents/GitHub/RM_Infantry/user/APP/FreeRTOS_middleware/FreeRTOS_middleware.c", "C", 0, 29, 17, 9, 55
"/Users/summerpray/Documents/GitHub/RM_Infantry/user/APP/FreeRTOS_middleware/FreeRTOS_middleware.h", "C++", 4, 0, 15, 3, 22
"/Users/summerpray/Documents/GitHub/RM_Infantry/user/APP/INS_task/INS_task.c", "C", 0, 264, 50, 81, 395
"/Users/summerpray/Documents/GitHub/RM_Infantry/user/APP/INS_task/INS_task.h", "C++", 46, 0, 23, 17, 86
"/Users/summerpray/Documents/GitHub/RM_Infantry/user/APP/calibrate_task/calibrate_task.c", "C", 0, 0, 0, 1, 1
"/Users/summerpray/Documents/GitHub/RM_Infantry/user/APP/calibrate_task/calibrate_task.h", "C++", 0, 0, 0, 1, 1
"/Users/summerpray/Documents/GitHub/RM_Infantry/user/APP/chassis_task/chassis_behaviour.c", "C", 0, 47, 10, 10, 67
"/Users/summerpray/Documents/GitHub/RM_Infantry/user/APP/chassis_task/chassis_behaviour.h", "C++", 7, 0, 0, 4, 11
"/Users/summerpray/Documents/GitHub/RM_Infantry/user/APP/chassis_task/chassis_task.c", "C", 0, 899, 389, 220, 1508
"/Users/summerpray/Documents/GitHub/RM_Infantry/user/APP/chassis_task/chassis_task.h", "C++", 137, 0, 46, 53, 236
"/Users/summerpray/Documents/GitHub/RM_Infantry/user/APP/detect_task/detect_task.c", "C", 0, 0, 0, 1, 1
"/Users/summerpray/Documents/GitHub/RM_Infantry/user/APP/detect_task/detect_task.h", "C++", 39, 0, 20, 5, 64
"/Users/summerpray/Documents/GitHub/RM_Infantry/user/APP/gimbal_key_control/gimbal_key_control.c", "C", 0, 95, 38, 30, 163
"/Users/summerpray/Documents/GitHub/RM_Infantry/user/APP/gimbal_key_control/gimbal_key_control.h", "C++", 5, 0, 0, 7, 12
"/Users/summerpray/Documents/GitHub/RM_Infantry/user/APP/gimbal_task/gimbal_behaviour.c", "C", 0, 0, 0, 1, 1
"/Users/summerpray/Documents/GitHub/RM_Infantry/user/APP/gimbal_task/gimbal_behaviour.h", "C++", 16, 0, 0, 5, 21
"/Users/summerpray/Documents/GitHub/RM_Infantry/user/APP/gimbal_task/gimbal_task.c", "C", 0, 982, 304, 234, 1520
"/Users/summerpray/Documents/GitHub/RM_Infantry/user/APP/gimbal_task/gimbal_task.h", "C++", 197, 0, 55, 78, 330
"/Users/summerpray/Documents/GitHub/RM_Infantry/user/APP/pid/pid.c", "C", 0, 86, 16, 9, 111
"/Users/summerpray/Documents/GitHub/RM_Infantry/user/APP/pid/pid.h", "C++", 30, 0, 17, 6, 53
"/Users/summerpray/Documents/GitHub/RM_Infantry/user/APP/remote_control/remote_control.c", "C", 0, 145, 35, 25, 205
"/Users/summerpray/Documents/GitHub/RM_Infantry/user/APP/remote_control/remote_control.h", "C++", 95, 0, 27, 18, 140
"/Users/summerpray/Documents/GitHub/RM_Infantry/user/APP/shoot/shoot.c", "C", 0, 0, 0, 1, 1
"/Users/summerpray/Documents/GitHub/RM_Infantry/user/APP/shoot/shoot.h", "C++", 77, 0, 33, 19, 129
"/Users/summerpray/Documents/GitHub/RM_Infantry/user/APP/shoot_task/shoot_task.c", "C", 0, 788, 334, 183, 1305
"/Users/summerpray/Documents/GitHub/RM_Infantry/user/APP/shoot_task/shoot_task.h", "C++", 76, 0, 10, 19, 105
"/Users/summerpray/Documents/GitHub/RM_Infantry/user/APP/start_task/start_task.c", "C", 0, 182, 73, 63, 318
"/Users/summerpray/Documents/GitHub/RM_Infantry/user/APP/start_task/start_task.h", "C++", 27, 0, 20, 12, 59
"/Users/summerpray/Documents/GitHub/RM_Infantry/user/APP/user_task/user_task.c", "C", 0, 46, 19, 16, 81
"/Users/summerpray/Documents/GitHub/RM_Infantry/user/APP/user_task/user_task.h", "C++", 3, 0, 8, 4, 15
"/Users/summerpray/Documents/GitHub/RM_Infantry/user/DSP/Include/arm_common_tables.h", "C++", 82, 0, 44, 11, 137
"/Users/summerpray/Documents/GitHub/RM_Infantry/user/DSP/Include/arm_const_structs.h", "C++", 32, 0, 41, 7, 80
"/Users/summerpray/Documents/GitHub/RM_Infantry/user/DSP/Include/arm_math.h", "C++", 2935, 0, 3403, 1219, 7557
"/Users/summerpray/Documents/GitHub/RM_Infantry/user/DSP/Include/core_sc000.h", "C++", 415, 0, 267, 183, 865
"/Users/summerpray/Documents/GitHub/RM_Infantry/user/DSP/Include/core_sc300.h", "C++", 903, 0, 401, 372, 1676
"/Users/summerpray/Documents/GitHub/RM_Infantry/user/FreeRTOS/croutine.c", "C", 0, 179, 159, 58, 396
"/Users/summerpray/Documents/GitHub/RM_Infantry/user/FreeRTOS/event_groups.c", "C", 0, 441, 202, 110, 753
"/Users/summerpray/Documents/GitHub/RM_Infantry/user/FreeRTOS/include/FreeRTOS.h", "C++", 656, 0, 209, 199, 1064
"/Users/summerpray/Documents/GitHub/RM_Infantry/user/FreeRTOS/include/FreeRTOSConfig.h", "C++", 63, 0, 108, 25, 196
"/Users/summerpray/Documents/GitHub/RM_Infantry/user/FreeRTOS/include/StackMacros.h", "C++", 62, 0, 89, 21, 172
"/Users/summerpray/Documents/GitHub/RM_Infantry/user/FreeRTOS/include/croutine.h", "C++", 68, 0, 671, 24, 763
"/Users/summerpray/Documents/GitHub/RM_Infantry/user/FreeRTOS/include/deprecated_definitions.h", "C++", 180, 0, 80, 62, 322
"/Users/summerpray/Documents/GitHub/RM_Infantry/user/FreeRTOS/include/event_groups.h", "C++", 43, 0, 726, 29, 798
"/Users/summerpray/Documents/GitHub/RM_Infantry/user/FreeRTOS/include/list.h", "C++", 96, 0, 321, 37, 454
"/Users/summerpray/Documents/GitHub/RM_Infantry/user/FreeRTOS/include/mpu_prototypes.h", "C++", 89, 0, 79, 10, 178
"/Users/summerpray/Documents/GitHub/RM_Infantry/user/FreeRTOS/include/mpu_wrappers.h", "C++", 95, 0, 86, 21, 202
"/Users/summerpray/Documents/GitHub/RM_Infantry/user/FreeRTOS/include/portable.h", "C++", 60, 0, 122, 26, 208
"/Users/summerpray/Documents/GitHub/RM_Infantry/user/FreeRTOS/include/projdefs.h", "C++", 66, 0, 81, 15, 162
"/Users/summerpray/Documents/GitHub/RM_Infantry/user/FreeRTOS/include/queue.h", "C++", 89, 0, 1656, 54, 1799
"/Users/summerpray/Documents/GitHub/RM_Infantry/user/FreeRTOS/include/semphr.h", "C++", 58, 0, 1085, 29, 1172
"/Users/summerpray/Documents/GitHub/RM_Infantry/user/FreeRTOS/include/task.h", "C++", 175, 0, 1999, 94, 2268
"/Users/summerpray/Documents/GitHub/RM_Infantry/user/FreeRTOS/include/timers.h", "C++", 64, 0, 1212, 39, 1315
"/Users/summerpray/Documents/GitHub/RM_Infantry/user/FreeRTOS/list.c", "C", 0, 73, 136, 32, 241
"/Users/summerpray/Documents/GitHub/RM_Infantry/user/FreeRTOS/portable/MemMang/heap_1.c", "C", 0, 66, 98, 25, 189
"/Users/summerpray/Documents/GitHub/RM_Infantry/user/FreeRTOS/portable/MemMang/heap_2.c", "C", 0, 137, 136, 42, 315
"/Users/summerpray/Documents/GitHub/RM_Infantry/user/FreeRTOS/portable/MemMang/heap_3.c", "C", 0, 40, 83, 17, 140
"/Users/summerpray/Documents/GitHub/RM_Infantry/user/FreeRTOS/portable/MemMang/heap_4.c", "C", 0, 247, 173, 59, 479
"/Users/summerpray/Documents/GitHub/RM_Infantry/user/FreeRTOS/portable/MemMang/heap_5.c", "C", 0, 253, 210, 65, 528
"/Users/summerpray/Documents/GitHub/RM_Infantry/user/FreeRTOS/portable/RVDS/ARM_CM4F/port.c", "C", 0, 341, 330, 119, 790
"/Users/summerpray/Documents/GitHub/RM_Infantry/user/FreeRTOS/portable/RVDS/ARM_CM4F/portmacro.h", "C++", 132, 0, 117, 46, 295
"/Users/summerpray/Documents/GitHub/RM_Infantry/user/FreeRTOS/queue.c", "C", 0, 1650, 572, 345, 2567
"/Users/summerpray/Documents/GitHub/RM_Infantry/user/FreeRTOS/tasks.c", "C", 0, 2885, 1232, 691, 4808
"/Users/summerpray/Documents/GitHub/RM_Infantry/user/FreeRTOS/timers.c", "C", 0, 622, 317, 154, 1093
"/Users/summerpray/Documents/GitHub/RM_Infantry/user/crc.c", "C", 0, 130, 29, 36, 195
"/Users/summerpray/Documents/GitHub/RM_Infantry/user/crc.h", "C++", 10, 0, 2, 9, 21
"/Users/summerpray/Documents/GitHub/RM_Infantry/user/hardware/adc/adc.c", "C", 0, 53, 0, 14, 67
"/Users/summerpray/Documents/GitHub/RM_Infantry/user/hardware/adc/adc.h", "C++", 6, 0, 0, 2, 8
"/Users/summerpray/Documents/GitHub/RM_Infantry/user/hardware/buzzer/buzzer.c", "C", 0, 41, 0, 14, 55
"/Users/summerpray/Documents/GitHub/RM_Infantry/user/hardware/buzzer/buzzer.h", "C++", 7, 0, 0, 2, 9
"/Users/summerpray/Documents/GitHub/RM_Infantry/user/hardware/can/can.c", "C", 0, 98, 0, 21, 119
"/Users/summerpray/Documents/GitHub/RM_Infantry/user/hardware/can/can.h", "C++", 6, 0, 0, 2, 8
"/Users/summerpray/Documents/GitHub/RM_Infantry/user/hardware/delay/delay.c", "C", 0, 82, 0, 8, 90
"/Users/summerpray/Documents/GitHub/RM_Infantry/user/hardware/delay/delay.h", "C++", 8, 0, 0, 3, 11
"/Users/summerpray/Documents/GitHub/RM_Infantry/user/hardware/exit_init/exit_init.c", "C", 0, 27, 0, 8, 35
"/Users/summerpray/Documents/GitHub/RM_Infantry/user/hardware/exit_init/exit_init.h", "C++", 5, 0, 0, 3, 8
"/Users/summerpray/Documents/GitHub/RM_Infantry/user/hardware/flash/flash.c", "C", 0, 413, 0, 68, 481
"/Users/summerpray/Documents/GitHub/RM_Infantry/user/hardware/flash/flash.h", "C++", 34, 0, 1, 6, 41
"/Users/summerpray/Documents/GitHub/RM_Infantry/user/hardware/fric/fric.c", "C", 0, 43, 6, 13, 62
"/Users/summerpray/Documents/GitHub/RM_Infantry/user/hardware/fric/fric.h", "C++", 8, 0, 0, 3, 11
"/Users/summerpray/Documents/GitHub/RM_Infantry/user/hardware/laser/laser.c", "C", 0, 22, 0, 5, 27
"/Users/summerpray/Documents/GitHub/RM_Infantry/user/hardware/laser/laser.h", "C++", 7, 0, 0, 2, 9
"/Users/summerpray/Documents/GitHub/RM_Infantry/user/hardware/led/led.c", "C", 0, 63, 0, 11, 74
"/Users/summerpray/Documents/GitHub/RM_Infantry/user/hardware/led/led.h", "C++", 14, 0, 0, 6, 20
"/Users/summerpray/Documents/GitHub/RM_Infantry/user/hardware/magazine/magazine.c", "C", 0, 208, 45, 39, 292
"/Users/summerpray/Documents/GitHub/RM_Infantry/user/hardware/magazine/magazine.h", "C++", 17, 0, 2, 7, 26
"/Users/summerpray/Documents/GitHub/RM_Infantry/user/hardware/motor_driver/motor_driver.c", "C", 0, 29, 1, 15, 45
"/Users/summerpray/Documents/GitHub/RM_Infantry/user/hardware/motor_driver/motor_driver.h", "C++", 8, 0, 11, 12, 31
"/Users/summerpray/Documents/GitHub/RM_Infantry/user/hardware/power_ctrl/power_ctrl.c", "C", 0, 41, 0, 8, 49
"/Users/summerpray/Documents/GitHub/RM_Infantry/user/hardware/power_ctrl/power_ctrl.h", "C++", 12, 0, 0, 4, 16
"/Users/summerpray/Documents/GitHub/RM_Infantry/user/hardware/rc/rc.c", "C", 0, 79, 5, 14, 98
"/Users/summerpray/Documents/GitHub/RM_Infantry/user/hardware/rc/rc.h", "C++", 7, 0, 0, 2, 9
"/Users/summerpray/Documents/GitHub/RM_Infantry/user/hardware/rng/rng.c", "C", 0, 29, 0, 8, 37
"/Users/summerpray/Documents/GitHub/RM_Infantry/user/hardware/rng/rng.h", "C++", 7, 0, 0, 2, 9
"/Users/summerpray/Documents/GitHub/RM_Infantry/user/hardware/spi/spi.c", "C", 0, 113, 1, 22, 136
"/Users/summerpray/Documents/GitHub/RM_Infantry/user/hardware/spi/spi.h", "C++", 8, 0, 0, 1, 9
"/Users/summerpray/Documents/GitHub/RM_Infantry/user/hardware/surper_cap/super_cap.c", "C", 0, 40, 61, 28, 129
"/Users/summerpray/Documents/GitHub/RM_Infantry/user/hardware/surper_cap/super_cap.h", "C++", 12, 0, 0, 6, 18
"/Users/summerpray/Documents/GitHub/RM_Infantry/user/hardware/sys/sys.c", "C", 0, 20, 0, 5, 25
"/Users/summerpray/Documents/GitHub/RM_Infantry/user/hardware/sys/sys.h", "C++", 47, 0, 6, 14, 67
"/Users/summerpray/Documents/GitHub/RM_Infantry/user/hardware/timer/timer.c", "C", 0, 187, 19, 64, 270
"/Users/summerpray/Documents/GitHub/RM_Infantry/user/hardware/timer/timer.h", "C++", 13, 0, 0, 3, 16
"/Users/summerpray/Documents/GitHub/RM_Infantry/user/hardware/uart7/uart7.c", "C", 0, 171, 79, 66, 316
"/Users/summerpray/Documents/GitHub/RM_Infantry/user/hardware/uart7/uart7.h", "C++", 18, 0, 3, 14, 35
"/Users/summerpray/Documents/GitHub/RM_Infantry/user/hardware/usart6/usart6.c", "C", 0, 131, 26, 46, 203
"/Users/summerpray/Documents/GitHub/RM_Infantry/user/hardware/usart6/usart6.h", "C++", 12, 0, 1, 8, 21
"/Users/summerpray/Documents/GitHub/RM_Infantry/user/hardware/usart7/usart7.c", "C", 0, 112, 22, 41, 175
"/Users/summerpray/Documents/GitHub/RM_Infantry/user/hardware/usart7/usart7.h", "C++", 11, 0, 0, 6, 17
"/Users/summerpray/Documents/GitHub/RM_Infantry/user/judge.c", "C", 0, 218, 105, 51, 374
"/Users/summerpray/Documents/GitHub/RM_Infantry/user/judge.h", "C++", 192, 0, 104, 57, 353
"/Users/summerpray/Documents/GitHub/RM_Infantry/user/kalman.c", "C", 0, 23, 38, 5, 66
"/Users/summerpray/Documents/GitHub/RM_Infantry/user/kalman.h", "C++", 19, 0, 4, 6, 29
"/Users/summerpray/Documents/GitHub/RM_Infantry/user/kalman_filter.c", "C", 0, 52, 15, 16, 83
"/Users/summerpray/Documents/GitHub/RM_Infantry/user/kalman_filter.h", "C++", 34, 0, 0, 11, 45
"/Users/summerpray/Documents/GitHub/RM_Infantry/user/main.c", "C", 0, 186, 51, 33, 270
"/Users/summerpray/Documents/GitHub/RM_Infantry/user/main.h", "C++", 75, 0, 21, 23, 119
"/Users/summerpray/Documents/GitHub/RM_Infantry/user/mpu6050/MPU_Temperature.c", "C", 0, 0, 63, 11, 74
"/Users/summerpray/Documents/GitHub/RM_Infantry/user/mpu6050/MPU_Temperature.h", "C++", 6, 0, 0, 4, 10
"/Users/summerpray/Documents/GitHub/RM_Infantry/user/mpu6050/eMPL/dmpKey.h", "C++", 444, 0, 16, 35, 495
"/Users/summerpray/Documents/GitHub/RM_Infantry/user/mpu6050/eMPL/dmpmap.h", "C++", 257, 0, 5, 3, 265
"/Users/summerpray/Documents/GitHub/RM_Infantry/user/mpu6050/eMPL/inv_mpu.c", "C", 0, 2091, 676, 276, 3043
"/Users/summerpray/Documents/GitHub/RM_Infantry/user/mpu6050/eMPL/inv_mpu.h", "C++", 86, 0, 31, 23, 140
"/Users/summerpray/Documents/GitHub/RM_Infantry/user/mpu6050/eMPL/inv_mpu_dmp_motion_driver.c", "C", 0, 966, 297, 121, 1384
"/Users/summerpray/Documents/GitHub/RM_Infantry/user/mpu6050/eMPL/inv_mpu_dmp_motion_driver.h", "C++", 57, 0, 25, 16, 98
"/Users/summerpray/Documents/GitHub/RM_Infantry/user/mpu6050/iic.c", "C", 0, 185, 11, 15, 211
"/Users/summerpray/Documents/GitHub/RM_Infantry/user/mpu6050/iic.h", "C++", 19, 0, 3, 8, 30
"/Users/summerpray/Documents/GitHub/RM_Infantry/user/mpu6050/mpu6050.c", "C", 0, 172, 63, 8, 243
"/Users/summerpray/Documents/GitHub/RM_Infantry/user/mpu6050/mpu6050.h", "C++", 80, 0, 19, 51, 150
"/Users/summerpray/Documents/GitHub/RM_Infantry/user/mpu6050/myiic.c", "C", 0, 108, 26, 31, 165
"/Users/summerpray/Documents/GitHub/RM_Infantry/user/mpu6050/myiic.h", "C++", 19, 0, 15, 20, 54
"/Users/summerpray/Documents/GitHub/RM_Infantry/user/user_lib/user_lib.c", "C", 0, 141, 42, 15, 198
"/Users/summerpray/Documents/GitHub/RM_Infantry/user/user_lib/user_lib.h", "C++", 34, 0, 14, 7, 55
"/Users/summerpray/Documents/GitHub/RM_Infantry/user/vision.c", "C", 0, 356, 188, 52, 596
"/Users/summerpray/Documents/GitHub/RM_Infantry/user/vision.h", "C++", 91, 0, 43, 49, 183
"Total", "-", 28814, 34046, 55181, 16977, 135018